###############################
S #   #     #   #       #     #
# # # # ### # ### # ### # ### #
#   #   #   #     # #   # #   #
# ####### ######### ####### ###
#       #     #   #       # # #
# ########### ### ### ### # # #
#           #   #   # #   # # #
######### # ### # # # # ### # #
#     #   #   #   #   #   #   #
# ### ### ####### ####### # ###
#   #   #     #     # #   #   #
### # # ##### ##### # # ### # #
#   # #     #     # #       # #
# ####### ####### # ### #######
# #     #     # #   #   #     #
# # ######### # ### # ### ### #
# # #     #   #   # # # #   # #
# # # ### # # ### ### # ### ###
# #   #   # #         # # #   #
# # # # ######### ##### # ### #
# # # # #     #   #   #       #
# # # # # ### # ### ### #######
#   # #   #   #   #   # #   # #
##### # ### ##### ### # # # # #
#   # #   # #     #     # # # #
# # # ##### # ##### # ### # # #
# # # #     # #     #   # #   #
# # # # ##### # ### ### # # ###
# #   #     #   #     #   #   E
###############################
