#############################################################
#                 #   #     #         #       #             #
# ##### ######### # # # ### # ### # ### # ##### ########### #
# #     #         # # # # #   # # # #   #     # #     #     #
# # ##### ######### # # # ##### # ### ####### # ### # # #####
# # #     #         # #     #   #   # #   #   # #   # # #   #
# # ### ### ######### ##### # # ### # ### # ### # ### # # ###
# #   #   # # #         # #   # # #       #       #   # #   #
##### ### # # # ####### # ##### # ############### ##### # # #
#   # #   # # # #   #         # # #             # #     # # #
# # # ##### # # # # # ######### # # ########### ### ####### #
# #   #   # # # # #   #           # #       #   #   #     # #
# ##### # # # # # ##### ########### # ### # # ### ### # # # #
#       #   # # # #     #     #     # #   # # #     # # #   #
# ########### # # # ##### # ### ##### # ##### ### # # # ### #
# #   #      S# # # #     # #   #   # #     #   #E# # # # # #
# # # ####### # # # ##### # # ### # ####### ### ### # # # # #
# # #       # # # #     # # # #   #       #   # #   # # #   #
# # # ##### # # # ##### ### # ### ####### # # # # ##### # ###
# # # #   #   # #     #   # #   #     #     # # #     # # # #
# # ### # # ### ##### ### # ### # ### ######### ##### # # # #
# #   # # # #   #     #   #   # # # #         #   #   # # # #
# ### # # ### ### ##### ##### ### # ######### ### # ### # # #
#   #   #   #   # #   # #   #       #   #   #   #   #   # # #
### # ##### ### # # # # # # ####### ### # # # # ##### ### # #
# # #   #   #   # # # # # #     #     # # #   #       #   # #
# # ### # # # ### ### # # ##### ##### # # ############# ### #
#   # # # # #   #     # # #   #   #     #   #         # #   #
# ### # # ##### ####### # # ##### # ####### # # ##### # ### #
# #     #     #   #   # # #       # #       # #   #   #     #
# ### ####### ### # # # # ### ####### ####### ### ######### #
#   # #     #   #   # # #   # #   #   #   #   # #       #   #
### ### ### # # ##### # ### # # # # ### # # ### ####### # ###
# #     # #   # #     #     #   #   # # #   #         #   # #
# ####### ##### # ### ############### # ##### ##### # ##### #
#   #   #     # #   # #         #     #   #     #   #   #   #
# # # # # # ### ### # # ##### ### # # ### ####### ##### ### #
# # # # # #   #   # # # #   # #   # #   # #     # #     #   #
# ### # # ### ### # ### ### # # ### ##### # ### # # ##### # #
#     #     #     #         #     #         #     #       # #
#############################################################