#####################
#   #           #   #
### # ##### ### # # #
#   #     #   #   # #
# ##### ##### ##### #
# #   # #   #     # #
# # # # # # ##### # #
#   #   # # #   # # #
# ##### # # # # # # #
# #   # # #  E# # # #
# # # ### ##### # ###
# # #   # #     #   #
# # ### # ######### #
# # #   #   #       #
# # # ##### # #######
# # #     # # #     #
### ##### # # # ### #
#  S#   #   #     # #
# ##### ########### #
#                   #
#####################